########
#P     #
# B    #
#     T#
########